00000000000000000000000000000000000000000000000000000000000000000
02110111111111011111111101111101111111111111111111011111111111110
00010100000101000000010001000101000000000000000101000000000001010
01110111110101111111011111110101011111011101111101110111111101010
01000000010100000001000000010101010000010101000000010100000100010
01111111010111011111111111010101110111010101011101110101110111110
01000001010001000000000001010101000101010101010001000100010000010
01011101011101111101111111010111011101110111011101011111011101110
00010101000100000100000001000000010001000000010101000101010001000
01110111110111010111011101110111010111011111010101110101011101110
01000001000001010001010100010101010000010001010100010101000100010
01110111011111011101010111011101110111110111010111010101110111010
01010000010000010101010001010000000100000000010101010000010101010
01010111110111110101010101010111111101110111110101010111110101010
01010100000001000101010101000100000001010100000100010100000100010
01011111111111011101111101111101111111011111110111111101111111130
00000000000000000000000000000000000000000000000000000000000000000
